account	Konto	wird in GUI verwendet, auf Website bisher: Account
account	Account	auf Website verwendet, in GUI: Konto
accounts	Konten	wird in GUI verwendet, auf Website bisher: Accounts
action file	Aktionsdatei
address	Adresse
address book	Adressbuch
airgap	Airgap
airgapped computer	Air-Gap-Computer	der; evtl. noch erklären: „vom Internet getrennter Computer“
algorithm	Algorithmus
Always latest stable version	Immer die neueste stabile Version
amount	Betrag
amounts	Beträge
anonymity	Anonymität
anonymity technology	Anonymitätstechnologie
API	API
argument	Argument	Kontext: Befehlszeile(CLI)
as root	als *root*
atomic unit	kleinste Einheit
authentic	authentisch
authenticity	Echtheit
authorized signers	 berechtigte Signaturgeber	(oder: autorisierte Signaturgeber?)
auto-config	Auto-Config	die; Kontext: MMS
auto-config manager	Auto-Config-Manager	Kontext: MMS
auto-config process	Auto-Config-Prozess	Kontext: MMS
auto-config token	Auto-Config-Token	der; Kontext: MMS
automatically	automatisch
bad signature	falsche Unterschrift	Kontext: GnuPG
balance	Guthaben
Base32 address	Base32-Adresse
Base64 address	Base64-Adresse
basic review	grundlegende Überprüfung
become unlocked	freigegeben
binary	Binärdatei	oder: nur „Datei“
binary file	Binärdatei	oder: nur „Datei“
Bitcoin	Bitcoin
bitcoin wallet	Bitcoin-Wallet
Bitmessage	Bitmessage
Bitmessage address	Bitmessage-Adresse
block	Block
block height	Blockhöhe
block reward	Blockbelohnung
block time	Blockzeit
blockchain	Blockchain	die
blocks	Blöcke
blog article	Blogeintrag
bluetooth	Bluetooth	das
bootable disk	bootfähiger Datenträger
Bootstrap-node	Bootstrap-Node
branch	Branch	der
bug	Bug	der
bug squashing	Beseitigung von Bugs
build	Build
build file	Build-Datei
Build instructions	Kompilieranleitung
building	Kompilierung
built-in	integriert
Bulletproofs	Bulletproofs
button	Button	der; Kontext: Webseite
button	Schaltfläche	Kontext: Webseite
by default	standardmäßig
cache	Cache	der
canonically-unique host	eindeutig zuordenbarer Host
CAPS LOCK	FESTSTELLTASTE
change	Rückgeld
chapter	Kapitel
clear	zurücksetzen
clearnet	Clearnet	das
CLI	Befehlszeile	evtl. mit „(CLI)“ ergänzen, für näheren Bezug zur CLI-Software
CLI wallet	CLI-Wallet
client	Client
clipboard	Zwischenablage
Code Documentation	Code-Dokumentation
coin	Coin	der
coinbase transaction	Coinbase-Transaktion
cold storage wallet	Cold-Storage-Wallet
cold wallet	Cold-Wallet
collaborator	Mitwirkender
command	Befehl	Kontext: Befehlszeile (CLI)
command line	Befehlszeile
command prompt	Eingabeaufforderung
Command Prompt window	Eingabeaufforderungsfenster
command-line interface	Befehlszeilenprogramm (CLI)
command-line parameter	Befehlszeilenparameter
commit	Commit	der
commit message	Commit-Nachricht
commit title	Commit-Titel
community	Community	die
Community Crowdfunding System	Community-Crowdfunding-System
compile	kompilieren
compiler	Kompilierer
completed proposals	vollendete Vorschläge
compliance	Einhaltung
component dependency	Komponentenabhängigkeit
compromised	kompromittiert
computer	Computer
confidential information	vertrauliche Information
confidential transaction	vertrauliche Transaktion
config file	Konfigurationsdatei
config manager	Konfigurationsmanager
configuration	Konfiguration
confirmation	Bestätigung
connected	verbunden
consensus	Konsens
console program	Befehlszeilenprogramm
constant	Konstante
container	Container	der; Kontext: Docker
contributing guidelines	Beitragsrichtlinien
contributor	Mitwirkender
convert	umtauschen	Kontext: Währungen
copied to clipboard	in die Zwischenablage kopiert
copyright	Urheberrecht
CPU	CPU	die
CPU miner	CPU-Miner	der
CrypoNote	CrypoNote
cryptocurrency	Kryptowährung
cryptographically	kryptographisch
CryptoNote	CryptoNote
current directory	aktuelles Verzeichnis
cursor	Mauszeiger
custom command	benutzerdefinierter Befehl
daemon	Hintergrunddienst
daemon log path	Hintergrunddienst-Log-Pfad
data directory	Datenverzeichnis
data sync	Datensynchronisierung
decentralization	Dezentralität	eher wenn gemeint: Beschaffenheit, Zustand (das Dezentralisiertsein)
decentralization	Dezentralisation	eher wenn gemeint: Prozess der Übertragung von Funktionen und Aufgaben auf verschiedene [untergeordnete] Stellen (Duden)
decentralization	Dezentralisierung	siehe 1. zu Dezentralisation
decentralized	dezentral	eher wenn gemeint: Beschreibung der Beschaffenheit, des Zustand (der Dezentralität)
decentralized	dezentralisiert	eher wenn gemeint: Beschreibung des Prozesses (der Dezentralisierung/Dezentralisation)
decode	decodieren
decrypt	entschlüsseln
denomination	Stückelung
dependency	Abhängigkeit
deposit	Einzahlung	Kontext: Konto
deposit	einzahlen	Kontext: Konto
deposit address	Einzahlungsadresse
destination	Ziel	gemeint: Ziel einer Transaktion (Empfänger)
detailed	detailliert
developer	Entwickler
developer guide	Entwicklerhandbuch
Developer Guides	Anleitungen für Entwickler
directory	Verzeichnis
distributed consensus	verteilter Konsens
distribution	Distribution	die
distro	Distribution	die
docker container	Docker-Container	der
double click	doppelklicken
download	Download	der
drive	Laufwerk
DriveLetter	Laufwerkbuchstabe
dust	Dust	der
e-mail	E-Mail	die
e-mail address	E-Mail-Adresse
e.g.	z.Bsp.
edit	bearbeiten
eepsite	Eepsite	die
eg.	z.Bsp.
emission	Verteilung
emission	Emission	eher: Verteilung
emission curve	Verteilungskurve
encrypted	verschlüsselt
encryption	Verschlüsselung
end user	Endbenutzer
entry	Eintrag
environment variable	Umgebungsvariable
error	Fehler
error message	Fehlermeldung
establish	einrichten
example	Beispiel
executable	ausführbare Datei	oder: Programmdatei
extension	Erweiterung
FAQ	Häufig gestellte Fragen
feature	Feature	das
fee	Gebühr
file	Datei
file extension	Dateierweiterung
file manager	Datei-Manager
file system	Dateisystem
fingerprint	Fingerabdruck
flag	Parameter
floodfill	Floodfill
fluffy blocks	Fluffy-Blocks	die
for example	zum Beispiel
fork	Fork	prefer to use _Upgrade_ or _Netzwerkupgrade_ when referring to Monero's scheduled hardforks
Forum Funding System	Forum-Finanzierungs-System
from scratch	von Null auf
full node	Full-Node	der
full path	vollständiger Pfad
funding required	Unterstützung benötigt
funds	Guthaben
funds	Geld
fungibility	Fungibilität
fungible	fungibel
Fuzz testing	Fuzz-Testing	das
garlic encryption	Garlic-Verschlüsselung
garlic routing	Garlic-Routing	das
gateway	Gateway	das
generate	erzeugen
generation	Erzeugung
getting started	erste Schritte
getting started	Grundlagen
git-log	Git-Log
good signature	korrekte Unterschrift	Kontext: GnuPG
Gpg4win	Gpg4win
gpg4win site	Gpg4win-Seite
GPU miner	GPU-Miner	der
graphics mode	Grafikmodus
group policies	Gruppenrichtlinien
GUI	GUI
GUI	graphische Nutzeroberfläche
guide	Anleitung
guidelines	Richtlinien
hardware	Hardware	die
hardware wallet	Hardware-Wallet
hash	Hash	der
hash file	Hash-Datei
hashing power	Hashpower	die
hashing rate	Hashrate	die; pl.: Hashraten
hashrate	Hashrate	die; pl.: Hashraten
hexadecimal	hexadezimal
hidden	versteckt
hidden service	Hidden Service	evtl. in Klammern "versteckter Dienst"
history	Verlauf	Kontext: Transaktionen (Wallet)
home directory	Benutzerverzeichnis
host	Host	der
hot wallet	Hot-Wallet
I2P	I2P
impersonation	Identitätswechsel
implementation	Implementierung
incoming	eingehend	Kontext: Transaktion
incompatible	inkompatibel
information	Informationen
initialize	initialisieren
install	installieren
install instructions	Installationsanweisungen
Installer	Installationsprogramm
instance	Instanz
integrated address	integrierte Adressse
integrity	Integrität
interface	Oberfläche
internet	Internet
isolation	Isolation
issue	Issue
jump service	Jump-Service	Kontext: I2P
key	Schlüssel
key exchange	Schlüsselaustausch
key image	Schlüsselbild
key pair	Schlüsselpaar
key set	Schlüsselsatz
key sets	Schlüsselsätze
keybinding	Tastaturkürzel
keyring	Schlüsselbund
Kleopatra	Kleopatra
Kovri	Kovri
label	Label	in GUI: Beschreibung (3x) oder Name (1x)
large pages	umfangreiche Seiten
launch	starten
lease	Lease	Kontext: I2P
lease-set	Lease-Set	Kontext: I2P
Ledger	Ledger	der – gemeint ist die Hardware-Wallet, aber: die Ledger-Wallet
Legal	Rechtliches
level of anonymity	Anonymitätsniveau
license	Lizenz
light theme	helles Design
Linux	Linux
local daemon startup flags	Startparameter für lokalen Hintergrunddienst
locally-unique host	lokal einzigartiger Host
locked funds	feststeckende Guthaben
log	Log
log level	Log-Level	das
Mac	Mac
machine	Computer	der
machine	Rechner
main emission	Hauptverteilung
manager	Manager
manual	Handbuch
merchant	Händler
merge	mergen
merge request	Merge-Request	der; pl.: Merge-Requests
message	Nachricht
message transport	Nachrichtentransport
message transport system	Nachrichtentransportsystem
mine	minen
mined	gemint
miner	Miner	der; pl. die Miner
minimum version	Mindestversion
mining	Mining	das
mining pool	Mining-Pool	der
mirror	Spiegel-Server	der
mixed-case	gemischt groß- und kleingeschrieben
MMS	MMS	das; Multisig Messaging System
mnemonic	mnemonisch
mnemonic seed	mnemonischer Seed	der
Monero	Monero
Monero address	Monero-Adresse
Monero binaries	Monero-Binärdateien
Monero binary files	Monero-Binärdateien
Monero blockchain	Monero-Blockchain
Monero daemon	Monero-Hintergrunddienst
Monero Forum	Moneroforum
Monero multisig transactions	Monero-Multisig-Transaktionen
Monero network	Monero-Netzwerk
Monero node	Monero-Node	der
Monero paper wallet	Monero-Paper-Wallet
Monero Press Kit	Monero-Presseunterlagen
Monero Project	Monero-Projekt
Monero Research Lab	Monero Research Lab
Monero signing key	Monero-Signaturschlüssel
Monero software	Monero-Software
Monero team	Monero-Team
Monero wallet	Monero-Wallet
Moneropedia	Moneropedia
money	Geld
most used	meistgebraucht
multisig	Multisig	die
multisig address	Multisig-Adresse
multisig sync data	Multisig-Synchronisierungsdaten
multisig transaction	Multisig-Transaktion
multisig wallet	Multisig-Wallet	die
network	Netzwerk
network connection	Netzwerkverbindung
network upgrade	Netzwerkupgrade	das
networking	Vernetzung
NiceHash	NiceHash
node	Node	der
note	Notiz
Note:	Hinweis:
obfuscate	verschleiern
obfuscation	Verschleierung
official	offiziell
offline wallet	Offline-Wallet
one time key	Einmalschlüssel
open source	Open Source
open tasks	offene Aufgaben
operating system	Betriebssystem
operation	Vorgang
operations	Vorgänge
order	Order	die; Kontext: Börsenhandel
origin	Ursprung	gemeint: Ursprung einer Transaktion (Sender)
orphaned	verwaist
OS	Betriebssystem
outgoing	ausgehend	Kontext: Transaktion
output	Output	der
paper	Paper	Kontext: wissenschaftl. Artikel
paper wallet	Paper-Wallet
paper wallet generator	Paper-Wallet-Generator	der
parameter	Parameter	Kontext: Befehlszeile
partial key	Teilschlüssel
partial key image	Teilschlüsselbild
partially signed transaction	teilweise signierte Transaktion
passphrase	Passphrase
password	Passwort
patch	Patch	der
path	Pfad
payment	Zahlung
payment ID	Payment-ID	auf Website verwendet, in GUI: Zahlungs-ID
payment ID	Zahlungs-ID	in GUI verwendet, auf Website: Payment-ID
payment proof	Zahlungsnachweis
payout	Auszahlung	Kontext: Mining-Pools
Pedersen commitment	Pedersen-Commitment	das
pending	ausstehend
per-transaction	transaktionsspezifisch
PGP key	PGP-Schlüssel
physical insulation	physische Isolierung
Pool	Pool	der; Kontext: Mining-Pool
pop up	Pop-up-Fenster
pop up window	Pop-up-Fenster
port	Port	der; Kontext: Netzwerk
portfolio	Portfolio	das; oder: Wallet
powershell	PowerShell	die
PowerShell	PowerShell	die
pregenerate	vorgenerieren
prepended	vorangestellt
prerequisites	Voraussetzungen
primary address	Hauptadresse
privacy	Datenschutz	je nach Kontext eher: Privatsphäre
privacy	Privatsphäre	je nach Kontext eher: Datenschutz
private key	privater Schlüssel
private spend key	privater Spend-Key
private view key	privater View-Key
program	Programm	das
proof	Nachweis
proof-of-work	Proof-of-Work
proposal	Vorschlag	Kontext: CCS
public address	öffentliche Adresse
public key	öffentlicher Schlüssel
public spend key	öffentlicher Spend-Key
public view key	öffentlicher View-Key
pull request	Pull-Request	der; pl.: Pull-Requests
PyBitmessage	PyBitmessage
QA workflow	QS-Arbeitsablauf
quality assurance	Qualitätssicherung
query	Abfrage	Kontext: Datenbank etc.
quick transfer	Schnelltransfer
RAM disk	RAM-Datenträger
read-only	schreibgeschützt
README	Readme	die; von Readme-Datei
rebase	Rebase	der
received	empfangen	Kontext: Transaktion
receiver	Empfänger
recipient	Empfänger
refactor	refaktorieren
refresh	aktualisieren
refund	Rückerstattung
refund address	Rückerstattungsadresse
release	Version
reliability	Zuverlässigkeit
remote node	Drittanbieternode
repository	Repository	das; pl.: Repositorys
request	Anforderung	Kontext: HTTP request etc.
required dependencies	erforderliche Abhängigkeiten
required signer	erforderlicher Signaturgeber
responsible disclosure	verantwortungsvolle Offenlegung
restore	wiederherstellen
restore height	Wiederherstellungshöhe
result	Ergebnis
Revuo Monero	Revuo Monero
reward	Belohnung
ring confidential transaction	vertrauliche Ringtransaktion
Ring CT	Ring-CT
ring signature	Ringsignatur
ringsize	Ringgröße
roadmap	Roadmap	die
route	leiten
routing	Routing
rpc	RPC	der; von Remote Procedure Call; Call = Aufruf
run	ausführen
Run As Administrator	Als Administrator ausführen
running instance	ausgeführte Instanz
scalability	Skalierbarkeit
scalable	skalierbar
scan	scannen
scan	prüfen
scan	durchsuchen
scan	suchen
scanned	gescannt
scanned	durchsucht
scroll	scrollen
second-layer solutions	Zweitschichtlösungen
section	Abschnitt
security	Sicherheit
security auditing	Sicherheitsaudit
security level	Sicherheitslevel
see website	siehe Webseite
seed	Seed	der
segregation height	Abspaltungshöhe
send	senden
send	schicken
send	verschicken
sender	Sender	gemeint: Sender einer Transaktion
server console	Server-Konsole
settings	Einstellungen
share	Share	der; von Anteil
signature	Signatur	die
signed	signiert
signer	Signaturgeber
signer configuration	Signaturgeberkonfiguration
signer information	Signaturgeberinformationen
signer list	Signaturgeberliste
signing address	signierende Adresse
signing key	Signaturschlüssel
skip	überspringen
slash	Slash
slider	Schieberegler
smart mining	Smart-Mining	das
solo mining	Solo-Mining	das
source code	Quellcode
space	Leerzeichen
specification	Spezifikation
specification review	Spezifikationsüberprüfung
spend key	Spend-Key	der
spend proof	Spendenachweis
Spendable Wallet	Wallet mit Vollzugriff
spendkey	Spend-Key	der
spent outputs	ausgegebene Outputs
stale data	veraltete Daten
standard address	Standardadresse
standard library	Standardbibliothek
state	Zustand	Kontext: endlicher Automat etc.
static analysis	statische Analyse
stealth address	Schattenadresse
step	Schritt
storage location	Speicherort
string	Zeichenfolge
style	Stil
style guide	Stilhandbuch
style reference	Stilverweis
subaddress	Subadresse
subcommand	Unterbefehl
subkey	Unterschlüssel
submit	senden
submit	übermitteln
subscription	Register	Kontext: I2P
sync data	Synchronisierungsdaten
synchronization	Synchronisierung
synchronized	synchronisiert
syncing	Synchronisierung
system	System
tag	Tag
tagged	getagged
tail emission	Anschlussverteilung
tampered with	manipuliert
technical specs	technische Spezifikationen
terminal	Terminal	das
terminology	Terminologie
testnet	Testnet	das
the full path	der vollständige Pfad
thread	Thread	der
timestamp	Zeitstempel
tokens	Token	der
Tor	Tor
Tor network	Tor-Netzwerk
transaction	Transaktion
transaction data	Transaktionsdaten
transaction details	Transaktionsdetails
transaction history	Transaktionsverlauf
transaction ID	Transaktions-ID	die
transaction key	Transaktionsschlüssel
transaction unlock time	Freigabedauer von Transaktionen
transfer	Transfer	eher: Zahlung
transfer	Zahlung	auch: Transfer
transport address	Transportadresse
troubleshooting	Problembehandlung
trusted third-party	vertrauenswürdiger Dritter
Tx descriptions	Transaktionsbeschreibungen
Tx ID	Tx-ID
Tx key	Tx-Schlüssel
Tx note	Tx-Notiz
tx pool	Transaktions-Pool
txpool	Transaktions-Pool
Ubuntu	Ubuntu
UI	Benutzeroberfläche
unlocked balance	verfügbares Guthaben
unlocked balance	entsperrtes Guthaben
unspent	nicht ausgegeben
USB stick	USB-Stick	der
user	Nutzer
user experience	Benutzerfreundlichkeit
user experience	Benutzererfahrung
user experience	Nutzererlebnis
user experience	Nutzungserlebnis
user guide	Benutzerhandbuch
User Guides	Anleitungen für Nutzer
user name	Benutzername
validity	Gültigkeit
verification	Überprüfung
verification	Verifizierung
verify	verifizieren
version	Version
view key	View-Key	der
view-only wallet	View-Only-Wallet
viewkey	View-Key	der
VPS	VPS	der; Virtual Private Server
Vulnerability Response Process	Vulnerability Response Process	der
wallet	Wallet
wallet creation height	Wallet-Erstellungshöhe
wallet file	Walletdatei
wallet log path	Wallet-Log-Pfad
wallet software	Wallet-Software	die
web browser	Webbrowser	der
website	Webseite	die
when asked	bei Aufforderung
Whonix workstation	Whonix-Workstation
wifi	WLAN	das
Windows	Windows
withdraw	abheben	Kontext: Konto
withdrawal	Abhebung	Kontext: Konto
word processor	Textverarbeitungsprogramm
work in progress	in Bearbeitung
workstation	Workstation	die
wrapper	Wrapper	der
XMRig	XMRig
